18~AB
~~~~A~~~~~
~~~~~~~~~A
~~~~~~~~~~
~~~~~~~~~~
~~~~~~~~~~
~A~~~~~~~~
~~~~~~A~~~
~~~~~~~~~~
~~~~~~~~~~
~~~~~~~~~~
~~~A~~~~~~
~~A~~A~~~A
~~~A~A~~~~
~~~~~~~~~~
~~~~~AA~~A
~~~~~~~~~~
~~~~~~~~~~
~~~~~~~~~~
